8 6
M1000000
01010110
01110110
00000010
11101000
E0000001